1111111111111111111111111111111111
1P00C00000000000000000000000000001
1010101010101010101010101010101001
1000C00000100000C00000000100000001
1010101010101010101010101010101001
10000000000000000000C0000000000001
1010101010101010101010101010101001
100C00000000000000000000000000C001
1010101010101010101010101010101001
10000000C00000000000000000E0000001
1111111111111111111111111111111111