1111111111111111111111111111111111
1000000000C000000000000000000C0001
100111000000000001111110O000000001
100001111111000001C010000000000001
1PE00100C0000000010000100000000001
1111111111111111111111111111111111