1111111111111111111111111111111111
10000000000000000C0000000000111001
10P0110000000C00011111100000000001
10001111111100000100100000C01111C1
10E011000000000001000010O000000111
1111111111111111111111111111111111
1111111111111111111111111111111111
1111111111111111111111111111111111
1111111111111111111111111111111111
1111111111111111111111111111111111
1111111111111111111111111111111111