11111111111111111111111111111111111111
1P000000000000000000000000000000000001
10111111111111111111111111111111111101
10100000000000000000000000000000000101
10101111111100000000000011111111110101
10101000000111100001111100000000010101
101010C00000000000000000000000C0010101
10001000C0000111111111100000C000101011
10101000000000000000000000000000101011
1010100000C00000000000000C000001011111
101010000000011100001110000000001O1011
10101000000111111111111110000000101O11
10101000011000000000000011000000101011
1010100001000000O000000010000000101011
101010001100000000000000110000001E1011
10101001111111111111111111100000101O11
10101000000000000000000000000000101011
10101111111111111111111111111111101011
10100000000000000000000000000000001011
10111111111111111111111111111111111011
10000000000000000000000000000000000011
11110000111111111111111111111111111111
11110000111111111111111111111111111111
10000000000000000000000000000000000001
10111111111111111111111111111111111101
10100000000000000000000000000000000101
10101111111100000000000011111111110101
10101000000111100001111100000000010101
101010C00000000000000000000000C0010101
10001000C0000111111111100000C000101011
11111111111111111111111111111111111111