11111111111111111111111111111111111
1C000000111111111111111111111110001
10000000111111111111111111111110001
100E000000C00000000000000C000000P01
10000000111111111111111111111110001
11111111111111111111111111111110001
11111111111111111111111111111111111
11111111111111111111111111111111111
11111111111111111111111111111111111
11111111111111111111111111111111111
11111111111111111111111111111111111
11111111111111111111111111111111111
11111111111111111111111111111111111